2222222222222222222222222222222222222222222
2733333333333333333333333333333333333333382
2511111111111111111111111111111111111111162
2510000000000000000000000000000000000000162
2510111111111111101111111111111111111110162
2510111111111111101111111000000000001110162
2510000000000000000000000011111111101100162
2510111111011111111110111000000000000000162
2510111111000000011000001111101111111100162
2510000000011111111022201111101111111100162
2510110000000000000022200000000000000000162
2510110111111111111022201111011111111100162
2510110110000000011000001100011000001100162
2510110110111111011110111111011110111100162
2510110000000000000000000000000000000000162
2510110111111111111101111111111111111100162
2510110100000000000000000000000000000000162
2510110111111110111101111111111111011110162
2510000000000000000000000000000000000000162
2511111111111111111111111111111111111111162
29444444444444444444444444444444444444444A2
2222222222222222222222222222222222222222222
